0 0 0 0 0 0 0 0 0 0 0 0 0 0 0 0 0 0 0 0 0 0 0 0 0 0 0 0 0 0 0 0 0 0 0 0 0 0 0 0 0 0 0 0 0 0 0 0 0 0 0 0 0 0 
0 0 0 0 0 0 0 0 0 0 0 0 0 0 0 0 0 0 0 0 0 0 0 0 0 0 0 0 0 0 0 0 0 0 0 0 0 0 0 0 0 0 0 0 0 0 0 0 0 0 0 0 0 0 
0 0 0 0 0 0 0 0 0 0 0 0 0 0 0 0 0 0 0 0 0 0 0 0 0 0 0 0 0 0 0 0 0 0 0 0 0 0 0 0 0 0 0 0 0 0 0 0 0 0 0 0 0 0 
0 156 155 154 153 152 151 150 149 148 147 146 145 144 143 142 141 0 0 0 0 136 135 134 133 132 131 130 129 128 127 126 125 124 123 0 0 0 0 110 109 108 107 106 105 104 103 102 101 102 103 104 105 0 
0 155 154 153 152 151 150 149 148 147 146 145 144 143 142 141 140 0 0 0 0 135 134 133 132 131 130 129 128 127 126 125 124 123 122 0 0 0 0 109 108 107 106 105 104 103 102 101 100 101 102 103 104 0 
0 154 153 152 151 150 149 148 147 146 145 144 143 142 141 140 139 0 0 0 0 134 133 132 131 130 129 128 127 126 125 124 123 122 121 0 0 0 0 108 107 106 105 104 103 102 101 100 99 100 101 102 103 0 
0 153 152 151 150 149 148 147 146 145 144 143 142 141 140 139 138 0 0 0 0 133 132 131 130 129 128 127 126 125 124 123 122 121 120 0 0 0 0 107 106 105 104 103 102 101 100 99 98 99 100 101 102 0 
0 152 151 150 149 148 147 146 145 144 143 142 141 140 139 138 137 0 0 0 0 132 131 130 129 128 127 126 125 124 123 122 121 120 119 0 0 0 0 106 105 104 103 102 101 100 99 98 97 98 99 100 101 0 
0 0 0 0 0 0 0 0 0 0 0 0 140 139 138 137 136 0 0 0 0 0 0 0 0 0 0 0 0 0 122 121 120 119 118 0 0 0 0 105 104 103 102 101 100 99 98 97 96 97 98 99 100 0 
0 0 0 0 0 0 0 0 0 0 0 0 139 138 137 136 135 0 0 0 0 0 0 0 0 0 0 0 0 0 121 120 119 118 117 0 0 0 0 106 105 104 103 102 0 0 0 0 95 96 97 98 99 0 
0 0 0 0 0 0 0 0 0 0 0 0 138 137 136 135 134 0 0 0 0 0 0 0 0 0 0 0 0 0 120 119 118 117 116 0 0 0 0 107 106 105 104 103 0 0 0 0 94 95 96 97 98 0 
0 0 0 0 0 0 0 0 0 0 0 0 137 136 135 134 133 0 0 0 0 0 0 0 0 0 0 0 0 0 119 118 117 116 115 0 0 0 0 108 107 106 105 104 0 0 0 0 93 94 95 96 97 0 
0 0 0 163 162 161 160 159 0 0 0 0 136 135 134 133 132 131 130 129 128 127 126 125 124 123 122 121 120 119 118 117 116 115 114 113 112 111 110 109 108 107 106 105 0 0 0 0 92 93 94 95 96 0 
0 0 0 162 161 160 159 158 0 0 0 0 137 136 135 134 133 132 131 130 129 128 127 126 125 124 123 122 121 120 119 118 117 116 115 114 113 112 111 110 109 108 107 106 0 0 0 0 91 92 93 94 95 0 
0 0 0 161 160 159 158 157 0 0 0 0 138 137 136 135 134 133 132 131 130 129 128 127 126 125 124 123 122 121 120 119 118 117 116 115 114 113 112 111 110 109 108 107 0 0 0 0 90 91 92 93 94 0 
0 0 0 160 159 158 157 156 0 0 0 0 139 138 137 136 135 134 133 132 131 130 129 128 127 126 125 124 123 122 121 120 119 118 117 116 115 114 113 112 111 110 109 108 0 0 0 0 89 90 91 92 93 0 
0 0 0 159 158 157 156 155 0 0 0 0 140 139 138 137 136 135 134 133 132 131 130 129 128 127 126 125 124 123 122 121 120 119 118 117 116 115 114 113 112 111 110 109 0 0 0 0 88 89 90 91 92 0 
0 0 0 158 157 156 155 154 0 0 0 0 0 0 0 0 0 0 0 0 0 132 131 130 129 128 127 0 0 0 0 0 0 0 0 0 0 0 0 0 0 0 0 0 0 0 0 0 87 88 89 90 91 0 
0 0 0 157 156 155 154 153 0 0 0 0 0 0 0 0 0 0 0 0 0 133 132 131 130 129 128 0 0 0 0 0 0 0 0 0 0 0 0 0 0 0 0 0 0 0 0 0 86 87 88 89 90 0 
0 0 0 156 155 154 153 152 0 0 0 0 0 0 0 0 0 0 0 0 0 134 133 132 131 130 129 0 0 0 0 0 0 0 0 0 0 0 0 0 0 0 0 0 0 0 0 0 85 86 87 88 89 0 
0 0 0 155 154 153 152 151 0 0 0 0 0 0 0 0 0 0 0 0 0 135 134 133 132 131 130 0 0 0 0 0 0 0 0 0 0 0 0 0 0 0 0 0 0 0 0 0 84 85 86 87 88 0 
0 0 0 154 153 152 151 150 149 148 147 146 145 144 143 142 141 140 139 138 137 136 135 134 133 132 131 132 133 134 135 136 137 138 139 0 0 0 0 74 75 76 77 78 79 80 81 82 83 84 85 86 87 0 
0 0 0 155 154 153 152 151 150 149 148 147 146 145 144 143 142 141 140 139 138 137 136 135 134 133 132 133 134 135 136 137 138 139 140 0 0 0 0 73 74 75 76 77 78 79 80 81 82 83 84 85 86 0 
0 0 0 156 155 154 153 152 151 150 149 148 147 146 145 144 143 142 141 140 139 138 137 136 135 134 133 134 135 136 137 138 139 140 141 0 0 0 0 72 73 74 75 76 77 78 79 80 81 82 83 84 85 0 
0 0 0 157 156 155 154 153 152 151 150 149 148 147 146 145 144 143 142 141 140 139 138 137 136 135 134 135 136 137 138 139 140 141 142 0 0 0 0 71 72 73 74 75 76 77 78 79 80 81 82 83 84 0 
0 0 0 158 157 156 155 154 153 152 151 150 149 148 147 146 145 144 143 142 141 140 139 138 137 136 135 136 137 138 139 140 141 142 143 0 0 0 0 70 71 72 73 74 75 76 77 78 79 80 81 82 83 0 
0 0 0 0 0 0 0 0 0 0 0 0 0 0 0 0 0 0 0 0 0 0 0 0 0 0 0 0 0 0 0 0 0 0 0 0 0 0 0 69 70 71 72 73 0 0 0 0 0 0 0 0 0 0 
0 0 0 0 0 0 0 0 0 0 0 0 0 0 0 0 0 0 0 0 0 0 0 0 0 0 0 0 0 0 0 0 0 0 0 0 0 0 0 68 69 70 71 72 0 0 0 0 0 0 0 0 0 0 
0 0 0 0 0 0 0 0 0 0 0 0 0 0 0 0 0 0 0 0 0 0 0 0 0 0 0 0 0 0 0 0 0 0 0 0 0 0 0 67 68 69 70 71 0 0 0 0 0 0 0 0 0 0 
0 0 0 0 0 0 0 0 0 0 0 0 0 0 0 0 0 0 0 0 0 0 0 0 0 0 0 0 0 0 0 0 0 0 0 0 0 0 0 66 67 68 69 70 0 0 0 0 0 0 0 0 0 0 
0 0 0 21 20 21 22 23 24 25 26 27 28 29 30 31 32 33 34 35 36 37 38 39 40 41 0 0 0 0 56 57 58 59 60 61 62 63 64 65 66 67 68 69 0 0 0 0 92 93 94 95 96 0 
0 0 0 20 19 20 21 22 23 24 25 26 27 28 29 30 31 32 33 34 35 36 37 38 39 40 0 0 0 0 55 56 57 58 59 60 61 62 63 64 65 66 67 68 0 0 0 0 91 92 93 94 95 0 
0 0 0 19 18 19 20 21 22 23 24 25 26 27 28 29 30 31 32 33 34 35 36 37 38 39 0 0 0 0 54 55 56 57 58 59 60 61 62 63 64 65 66 67 0 0 0 0 90 91 92 93 94 0 
0 0 0 18 17 18 19 20 21 22 23 24 25 26 27 28 29 30 31 32 33 34 35 36 37 38 0 0 0 0 53 54 55 56 57 58 59 60 61 62 63 64 65 66 0 0 0 0 89 90 91 92 93 0 
0 0 0 17 16 17 18 19 20 21 22 23 24 25 26 27 28 29 30 31 32 33 34 35 36 37 0 0 0 0 52 53 54 55 56 57 58 59 60 61 62 63 64 65 0 0 0 0 88 89 90 91 92 0 
0 0 0 16 15 16 17 18 0 0 0 0 0 0 0 0 0 0 0 0 0 34 35 36 37 38 0 0 0 0 51 52 53 54 55 0 0 0 0 0 0 0 0 0 0 0 0 0 87 88 89 90 91 0 
0 0 0 15 14 15 16 17 0 0 0 0 0 0 0 0 0 0 0 0 0 35 36 37 38 39 0 0 0 0 50 51 52 53 54 0 0 0 0 0 0 0 0 0 0 0 0 0 86 87 88 89 90 0 
0 0 0 14 13 14 15 16 0 0 0 0 0 0 0 0 0 0 0 0 0 36 37 38 39 40 0 0 0 0 49 50 51 52 53 0 0 0 0 0 0 0 0 0 0 0 0 0 85 86 87 88 89 0 
0 0 0 13 12 13 14 15 0 0 0 0 0 0 0 0 0 0 0 0 0 37 38 39 40 41 0 0 0 0 48 49 50 51 52 0 0 0 0 0 0 0 0 0 0 0 0 0 84 85 86 87 88 0 
0 0 0 12 11 12 13 14 0 0 0 0 47 46 45 44 43 42 41 40 39 38 39 40 41 42 43 44 45 46 47 48 49 50 51 0 0 0 0 92 91 90 89 88 87 86 85 84 83 84 85 86 87 0 
0 0 0 11 10 11 12 13 0 0 0 0 48 47 46 45 44 43 42 41 40 39 40 41 42 43 44 45 46 47 48 49 50 51 52 0 0 0 0 91 90 89 88 87 86 85 84 83 82 83 84 85 86 0 
0 0 0 10 9 10 11 12 0 0 0 0 49 48 47 46 45 44 43 42 41 40 41 42 43 44 45 46 47 48 49 50 51 52 53 0 0 0 0 90 89 88 87 86 85 84 83 82 81 82 83 84 85 0 
0 0 0 9 8 9 10 11 0 0 0 0 50 49 48 47 46 45 44 43 42 41 42 43 44 45 46 47 48 49 50 51 52 53 54 0 0 0 0 89 88 87 86 85 84 83 82 81 80 81 82 83 84 0 
0 0 0 8 7 8 9 10 0 0 0 0 51 50 49 48 47 46 45 44 43 42 43 44 45 46 47 48 49 50 51 52 53 54 55 0 0 0 0 88 87 86 85 84 83 82 81 80 79 80 81 82 83 0 
0 0 0 7 6 7 8 9 0 0 0 0 0 0 0 0 0 0 0 0 0 43 44 45 46 47 48 49 50 51 52 53 54 55 56 0 0 0 0 0 0 0 0 0 0 0 0 0 78 79 80 81 82 0 
0 0 0 6 5 6 7 8 0 0 0 0 0 0 0 0 0 0 0 0 0 44 45 46 47 48 0 0 0 0 53 54 55 56 57 0 0 0 0 0 0 0 0 0 0 0 0 0 77 78 79 80 81 0 
0 0 0 5 4 5 6 7 0 0 0 0 0 0 0 0 0 0 0 0 0 45 46 47 48 49 0 0 0 0 54 55 56 57 58 0 0 0 0 0 0 0 0 0 0 0 0 0 76 77 78 79 80 0 
0 0 0 4 3 4 5 6 0 0 0 0 0 0 0 0 0 0 0 0 0 46 47 48 49 50 0 0 0 0 55 56 57 58 59 0 0 0 0 0 0 0 0 0 0 0 0 0 75 76 77 78 79 0 
0 0 0 3 2 3 4 5 6 7 8 9 10 11 12 13 14 0 0 0 0 47 48 49 50 51 0 0 0 0 56 57 58 59 60 61 62 63 64 65 66 67 68 69 70 71 72 73 74 75 76 77 78 0 
0 0 0 2 1 2 3 4 5 6 7 8 9 10 11 12 13 0 0 0 0 48 49 50 51 52 0 0 0 0 57 58 59 60 61 62 63 64 65 66 67 68 69 70 71 72 73 74 75 76 77 78 79 0 
0 0 0 3 2 3 4 5 6 7 8 9 10 11 12 13 14 0 0 0 0 49 50 51 52 53 0 0 0 0 58 59 60 61 62 63 64 65 66 67 68 69 70 71 72 73 74 75 76 77 78 79 80 0 
0 0 0 4 3 4 5 6 7 8 9 10 11 12 13 14 15 0 0 0 0 50 51 52 53 54 0 0 0 0 59 60 61 62 63 64 65 66 67 68 69 70 71 72 73 74 75 76 77 78 79 80 81 0 
0 0 0 5 4 5 6 7 8 9 10 11 12 13 14 15 16 0 0 0 0 51 52 53 54 55 0 0 0 0 60 61 62 63 64 65 66 67 68 69 70 71 72 73 74 75 76 77 78 79 80 81 82 0 
0 0 0 0 0 0 0 0 0 0 0 12 13 14 15 16 17 0 0 0 0 0 0 0 0 0 0 0 0 0 0 0 0 0 0 0 0 0 0 0 0 0 0 0 0 0 0 0 0 0 0 0 0 0 
